wals_code	iso_code
aab	
aar	aiw
aba	aau
abb	shu
abd	abi
abe	apc
abh	abv
abi	axb
abk	abk
abm	akz
abn	ard
abo	arv
abu	kgr
abv	abz
abw	abe
abz	abq
ace	ace
acg	aca
ach	guq
aci	acr
acl	ach
acm	acv
acn	acn
aco	kjq
acu	acu
ada	ads
adg	adn
adi	adj
adk	ano
adn	adt
adt	ady
ady	ady
adz	adz
aea	ale
aeg	arz
ael	ayl
afr	afr
aga	agd
agb	agb
agc	agt
agd	duo
agh	agq
agl	agx
agm	njm
agm	nri
ago	aoa
agr	agr
agt	lnj
agu	agu
agw	wbj
aho	arp
ahs	mey
aht	aht
ahu	ahh
aik	tba
ain	ain
aiz	ahp
aja	aja
ajg	ajg
aji	aji
aka	axk
akb	abj
akc	aci
akh	ahk
akk	akx
akl	akl
akm	rmz
akn	aka
ako	acy
akr	ari
akw	ake
ala	amp
alb	aln
alb	als
alc	
ald	ald
ale	ale
alg	alq
alk	apr
all	nrz
aln	alp
als	aes
alt	gsw
alu	alr
alw	alh
alx	btz
aly	aly
ama	aie
amb	abt
amc	amc
amd	adx
ame	aey
amh	amh
ami	ami
amk	amr
aml	omb
amm	amm
amn	amn
amo	amo
amp	aer
amq	amk
amr	ary
ams	arb
amt	adx
amu	ame
amx	imi
amz	amu
ana	aro
anc	anc
ane	anz
ang	agg
ani	hnh
anj	aty
anl	apc
ann	aoi
ano	nun
ant	agm
anu	cko
anx	ani
any	anu
ao	njo
aoj	aoj
apa	ajp
apc	apm
ape	apz
api	apn
apj	apj
apk	apq
apl	apy
apt	apt
apu	apu
apw	apw
ara	arw
arb	arl
arc	aqc
ard	jbj
arg	afb
arh	acw
ari	laz
arj	afb
ark	akr
arl	apc
arm	hye
arn	shu
aro	aia
arp	ape
arq	acm
arr	aer
ars	ayn
arv	ajp
arw	hye
arx	alu
arz	hye
ash	ady
asl	ase
asm	tml
aso	alt
ass	asm
ast	ast
asu	asu
asy	apc
ata	tay
atb	atq
atc	upv
ath	aph
ati	atj
atk	aqp
atm	kuz
atq	ems
ats	atw
atu	aeb
au	avt
aul	aul
aus	asf
auy	auy
ava	ava
avk	avi
avo	avu
avt	avn
awa	awb
awd	awa
awe	are
awi	awi
awk	png
awn	awn
awp	kwi
awt	kmn
awy	auw
axv	akv
ayi	any
aym	ayc
ayn	aib
ayo	
ayr	ayo
ayw	nfl
aze	azb
aze	azj
azi	azb
baa	nvm
baa	bbb
bab	bav
bac	wdj
bad	bde
bae	bae
baf	bfd
bag	bmi
bah	xir
bai	bca
baj	bdl
bak	bkc
bal	ban
bam	bam
ban	bcw
bao	peh
baq	brg
bar	bfa
bas	bas
bat	bya
bau	bbd
baw	bgr
bbf	bbo
bbl	bvx
bbm	ptu
bbu	brm
bbw	gup
bca	bdy
bch	shy
bco	blc
bdc	brc
bdg	bfq
bdk	bdk
bdm	bia
bdu	buu
bdw	bdw
beb	bef
bec	ctg
bee	beq
beg	dbj
bej	bej
bel	byw
bem	bem
ben	ben
beo	bue
ber	wti
bet	bev
bez	kap
bfd	bif
bfg	
bfi	ksf
bga	bng
bgg	bgz
bgi	bgq
bgl	sab
bgm	dba
bgn	
bgo	bot
bgr	fuu
bgs	bsp
bgv	kva
bgz	bdg
bhi	bhb
bhn	bjh
bho	bho
bhu	unr
bia	bip
bia	brf
bid	bid
big	yul
bii	bzr
bik	bhw
bil	blb
bim	bhp
bin	bhg
bio	bio
biq	bpr
bir	bom
bis	bib
bit	bth
biu	bzi
bjs	ssb
bka	bdh
bkb	xub
bkd	bkd
bki	bkq
bkl	bcl
bkn	bdu
bkr	btx
bkt	bkk
bku	bri
bla	bla
blc	bgp
ble	bci
blg	blw
blj	koe
blk	blz
bln	byn
blq	bol
blr	bel
blt	bft
blu	lua
blx	bll
bly	nad
blz	bjt
blz	ble
bma	tzm
bmb	bim
bmn	bax
bmr	bmu
bmz	mzb
bna	jaa
bnb	bck
bnd	bza
bng	byx
bni	bin
bnj	bdy
bnk	abb
bnl	bjb
bnm	bjr
bnn	bcm
bno	bao
bnq	nhb
bnr	nbj
bnt	bnq
bnu	
bnw	bwi
boa	kvg
bob	bni
bod	brx
boi	bzf
boj	adi
bok	bqc
bol	bli
bon	bpu
boq	adi
bor	boa
bos	bos
bou	oua
boz	boz
bpa	bwr
bpb	bdq
bqb	eus
bqg	eus
bqh	eus
bqi	eus
bql	eus
bqn	eus
bqo	eus
bqr	eus
bqs	eus
bqz	eus
bra	brb
brb	bba
brc	brn
brd	bcj
bre	bre
brf	rif
brh	brh
bri	bzd
brj	bji
brk	bkl
brl	loy
brm	mya
brn	bds
bro	tcs
brp	wra
brr	bor
brs	bsn
bru	bru
brw	brv
bry	byr
brz	bvq
bse	tzm
bsh	buf
bsi	siz
bsk	bak
bsl	bfi
bsm	bis
bso	eus
bsq	eus
bsr	bsc
bth	bhm
bti	
btk	bnc
bto	bbc
bua	bvr
bub	bvb
bud	bdm
bug	bug
bui	bzq
buj	nmg
buk	bxk
bul	bul
bum	tkw
bun	buo
bur	bsk
bus	bqp
but	bxm
buu	mhs
buw	bum
buy	bwu
bvi	bbn
bvi	wiv
bwa	bdy
bwc	bdr
bxj	bxj
bya	bee
bys	bsw
byu	bdy
bzi	bvz
cab	cjp
cac	cbv
cad	cad
cah	chl
cai	suq
cak	cak
cam	kbh
can	cbu
cap	kaq
car	car
cas	cbr
cat	cto
cav	cav
cax	cpc
cax	cni
cay	cbi
cba	boi
cbo	cao
cch	coz
cck	cic
ccm	cco
cco	
ccp	coc
cct	cho
cde	mch
cea	csw
ceb	ceb
cec	cob
cem	cam
cga	old
cha	cha
chb	can
chc	che
chd	cdn
che	chr
chg	nbc
chh	sgw
chi	cid
chj	cnm
chj	cac
chk	ckt
chl	cjh
chm	cji
chn	chx
cho	chd
chp	chp
chq	chq
chr	crw
chs	csy
cht	cya
chu	cag
chv	chv
chw	cja
chx	clo
chy	cbt
chz	nan
cic	nya
cil	lua
cin	inz
cjo	pei
ckh	mrn
ckl	chh
ckr	xra
cku	wac
cla	clm
clc	
cld	cld
cle	cle
cln	clh
cln	cht
cly	clw
cma	cbg
cmc	xcm
cme	cjm
cmh	ute
cmk	xch
cml	rab
cmn	com
cmr	mrh
cmx	coo
cmy	chf
cnl	ram
cnm	knm
cnt	yue
coa	xcw
coc	cod
coe	crd
cof	con
cog	kog
coi	caa
col	ctu
com	swb
coo	csz
cop	cop
cor	crn
cos	css
cpa	cjo
cpl	cpa
cpn	cdm
cpw	ciw
cpy	cap
cqt	cax
cre	crk
crg	gui
crh	cje
cri	crh
crj	cbd
crk	mus
crl	cal
crn	cor
cro	cro
crp	cbc
crq	crx
crt	crq
crt	crt
csc	cso
csf	cuc
csh	cbs
csk	csk
csl	csl
cso	ctp
ctc	cut
cte	cnt
cti	ctd
ctl	cat
ctm	ctm
ctt	cta
ctw	chc
cua	cua
cub	cub
cuc	
cui	cui
cul	cul
cum	ncu
cup	cup
cur	kpc
cut	
cuu	chk
cvc	cbk
cve	cjv
cwe	col
cya	ctp
cyg	cay
cyn	chy
cyv	cyb
cze	ces
daa	kzf
dab	dbq
dab	dkx
dad	mps
dag	dgz
dah	dal
dak	dak
dam	mbp
dan	dnj
dar	dry
dat	tcc
daw	kwa
day	dai
dbd	dav
dbr	nld
dbw	daf
dca	dgc
dda	duj
ddf	daj
ddj	god
dds	dds
def	afn
deg	deg
den	dny
der	kbv
des	des
det	shg
deu	der
dga	dga
dgb	dag
dge	gsg
dgi	dgo
dgo	doo
dgr	dta
dgx	ing
dha	dsh
dhb	bjy
dhi	div
dhl	dhl
dhm	dhi
dhr	dhr
dhu	dhu
dhw	tbh
did	did
die	dih
dig	mhu
dim	dim
din	dip
dio	dyo
diy	dif
diz	mdx
dja	dyy
dji	jig
djm	djr
djn	dji
djp	duj
djr	ddj
dli	nld
dlm	kbv
dma	dma
dmi	dus
dmk	dmk
dms	dis
dng	diz
dni	dni
dnw	daa
dob	kvo
dok	ngc
dol	dlg
dom	rmt
don	kmc
dou	tds
doy	dow
dre	dhv
drg	dar
dri	prs
drm	drd
dsh	dan
dts	dts
dua	dua
dug	gwd
duk	dud
dul	duu
dum	vam
dun	duc
dut	nld
duz	zea
dyi	dbl
dym	dyi
dyu	dyu
ebi	igb
edo	etr
efi	efi
ega	ega
egn	enn
eip	eip
eja	etu
eka	ekg
eko	eko
els	mrf
emb	emp
emc	cmi
eme	eme
eml	emb
emm	amy
ena	enq
ene	enh
ene	enf
eng	eng
eno	eno
eny	gey
epe	sja
erk	erk
err	erg
ese	ese
esm	
ess	esq
est	est
ets	ets
eud	opt
eve	evn
evn	eve
ewa	ewe
ewe	ewe
ewo	ewo
eya	eya
far	fao
fas	faa
fbf	fuh
fea	frs
fef	fmp
fgo	fub
fgu	fuf
fij	fij
fin	fin
fio	kng
fiw	wyy
fli	fuh
fma	fuc
fni	fuv
fno	frr
foe	foi
fon	fon
for	for
fox	sac
fqs	fqs
frd	frd
fre	fra
fri	frs
frw	fry
fsl	fse
fua	fub
fue	fud
ful	fun
fum	ffm
fur	fvr
fus	fuc
fut	fut
fuz	cdo
fye	pym
ga	gaa
gaa	gbu
gad	ged
gae	gla
gag	gag
gah	gah
gal	adi
gam	gmv
gan	apq
gap	pwg
gar	grt
gau	bar
gav	gvo
gay	gay
gba	bar
gbb	gbp
gbc	pov
gbe	gsw
gbk	gya
gbl	deu
gcy	ell
gdb	gbj
gdf	gdf
gdi	god
gdk	gdb
gdl	gcf
gdr	gid
gds	gaj
gel	nlg
geo	kat
ger	deu
gfr	gcr
ggd	ggd
ggu	gnr
gha	deu
ghb	guh
gho	aaa
ghr	bfu
gid	bdy
gil	glk
gim	bcq
gir	glj
git	git
giz	gis
gji	gue
gjj	gub
gku	pue
gla	gqu
glc	glg
gll	gbi
gln	gvf
glp	dhg
gma	deu
gmb	gum
gml	kld
gmt	gnn
gmw	gvs
gmz	guk
gna	gva
gnb	wlg
gnd	gqa
gnn	gww
gno	gvc
gny	gyy
goa	guc
god	gdo
goe	ank
gog	ggw
goj	gju
gok	gkn
gol	gol
gon	ggo
gon	gno
goo	gni
gor	gow
gos	gsw
gpz	gsw
grb	grj
gre	kal
grf	cab
grg	gge
grj	var
grk	ell
grm	gux
grn	gur
gro	goa
grp	ksh
grr	wrk
grs	gyb
grt	gor
grw	kal
gsl	gss
gso	kal
gtg	gsw
gth	deu
gti	deu
gto	gta
gua	gug
gud	gde
gue	gxx
guf	guf
gug	ktd
guh	ghs
guj	guj
gul	glu
gum	kgs
gun	yas
guq	cbd
gur	gvr
gus	guz
gut	gux
guu	kky
guw	guw
gvi	bar
gwa	gbr
gwe	wep
gwo	kcg
gyb	guo
gyc	jya
gzu	gsw
had	hts
hai	hdn
hai	hax
hak	hak
hal	hla
ham	hmt
han	hni
har	tmd
hat	had
hau	hau
hav	yuf
haw	haw
hay	vay
hba	heb
hcr	hat
hdi	xed
heb	heb
heh	heh
hei	hei
hem	hem
her	her
hhu	wos
hia	cbd
hid	hid
hil	hil
hin	hin
hix	hix
hks	
hlb	hlb
hli	hur
hln	hal
hlp	yuf
hlu	hur
hma	hmr
hmb	hub
hmd	mww
hmi	hto
hmo	cqd
hmo	hnj
hmr	amf
hmu	hux
hna	hna
hnd	hke
hnk	gin
hnn	hnn
hno	hdn
ho	hoc
hoa	hoa
hok	nan
hol	hoo
hop	hop
hpd	jup
hre	hre
hrr	har
hrs	hss
hsl	has
htc	hus
htt	hto
hua	ygr
huc	huc
hui	hch
hum	huu
hun	hun
hup	hup
hve	huv
hwc	hwc
hwr	hac
hya	hay
hyo	csh
hzb	huz
iaa	iai
iat	ian
iau	tmu
iba	iba
ibi	ibb
ibn	ibg
ice	isl
ics	icl
idn	viv
ido	idu
idu	clk
ifi	ita
ifm	ifm
ifu	ifb
iga	inb
igb	ibo
ige	ige
ign	ign
igs	tbi
iha	ihp
iir	pmy
ijo	ijc
ik	ikx
ika	arh
ila	ilb
ill	mia
ilo	ilo
imo	imn
ina	szp
ind	ind
ing	inh
inj	ind
inn	ynd
inr	ikt
ins	ike
inu	esi
ipi	ins
ipk	pks
iql	ike
iqu	iqu
ird	gle
iri	gle
irm	gle
irq	irk
irr	irh
irs	isg
irx	irn
isa	ksi
ise	its
ish	isk
isi	srl
isl	
isn	isd
iso	iso
iss	isr
ita	ita
itb	egl
ite	itl
itg	lij
itn	nap
ito	ito
itu	pms
itw	itv
itz	itz
iva	ivv
ivs	ivv
iwa	ibd
iwm	iwm
ixc	ixc
ixi	ixl
izh	izh
izi	izz
jab	jae
jad	bod
jah	jhi
jak	jai
jak	jac
jam	djd
jaq	jqr
jar	jar
jav	jav
jbt	jbt
jcr	jam
jeb	jeb
jeh	jeh
jel	
jem	tow
jia	jya
jib	shv
jin	jiy
jin	jiu
jiv	jiv
jlu	lwo
jmm	jaa
jmo	bex
jms	djm
jng	kac
joh	
jom	tlo
jpn	jpn
jpr	jru
jrn	jur
jrw	anq
jua	
jug	nst
juh	ktz
juk	jbu
jum	jua
jun	jun
jur	juc
jva	kpj
jwr	jaa
kaa	arr
kab	kbd
kac	xac
kad	xtc
kae	tbd
kag	kge
kai	kct
kaj	bpp
kak	kbq
kal	gwc
kam	xbr
kan	ogo
kao	kyj
kap	kcl
kaq	
kar	kah
kas	kas
kat	kmg
kau	pss
kaw	kgk
kay	gyd
kaz	kaz
kba	kam
kbi	nkf
kbl	kab
kbo	kbx
kbr	kys
kbt	xkp
kbu	kbl
kbw	bwe
kby	kbp
kch	khq
kda	kfc
kdg	kuq
kdw	kbc
kdz	kzj
kea	kjb
ked	ksx
kef	kbr
kei	kei
kek	kek
kel	sbc
kem	ahg
ken	kyq
keo	xxk
ker	ker
ket	ket
keu	
kew	kjs
kew	kew
kfc	
kfe	kfz
kfy	kir
kga	zga
kgi	cou
kgl	ubu
kgm	kdm
kgr	kki
kgt	ikt
kgu	ktg
kgy	kgy
kgz	kir
kha	khk
khd	khg
khg	klr
khi	kjj
khk	kjh
khl	klj
khm	khm
khn	kkh
kho	naq
khr	khr
khs	kha
khu	cnk
khv	khv
khw	khw
kic	kic
kie	geb
kij	gia
kik	kik
kil	lub
kim	kig
kin	kin
kio	kio
kiq	xal
kir	cme
kis	kqs
kit	kii
kiu	kvd
kiw	kjd
kje	coe
kji	kmr
kjn	kjn
kjo	kjc
kjr	kqy
kkb	xon
kkl	bqy
kkn	knn
kko	knk
kkp	kaa
kkq	kui
kkr	kiy
kkt	kkk
kku	kfq
kkv	khl
kkw	zkk
kky	kne
kkz	kex
kla	klu
klb	hbb
klg	kle
klh	kls
kli	lew
klk	xuo
kll	bco
klm	kla
kln	kvw
klp	kyl
klq	kmh
klr	shm
kls	fla
klt	kzi
klv	kij
klw	klb
kly	mwp
klz	kck
kma	kay
kmb	tyn
kmb	wng
kmh	kgj
kmi	kcu
kmj	kdj
kmk	xal
kmn	kue
kmo	kpx
kmp	kup
kmr	kgq
kms	xas
kmt	kmt
kmu	kjg
kmw	xmu
kmz	kms
kna	ktn
knb	khd
knc	uwa
knd	kan
kng	kgp
kni	kma
knk	kna
knm	kun
knn	kfk
kno	
knp	kcd
knq	rop
knr	knc
knu	kyx
knw	mjd
knz	khg
koa	cku
kob	kpw
kod	kfa
koe	xwg
koh	bcs
koi	kbk
kok	trp
kol	kfb
kom	xom
kon	kng
koo	kvv
kop	koi
kor	kor
kos	kos
kot	kfe
kou	bkm
kow	kst
koy	kff
kpa	kpk
kpe	xpe
kpm	pam
kpn	kpg
kpo	kpo
kpw	pwo
kpw	kjp
kqq	kqq
kra	leu
krb	gil
krc	krc
krd	ckb
kre	krs
krf	kpr
krg	sna
krh	xra
kri	kzw
krj	gbd
krk	kyh
krl	krl
krm	kdr
krn	kqz
kro	kgo
krq	krk
krr	kxa
krt	kpt
krw	khe
kry	kpy
krz	kry
ksa	kee
kse	ses
ksg	ksw
ksh	kju
ksi	puo
ksl	xki
ksm	xsm
ksn	
ksp	kia
ksr	kje
kss	kss
ksu	csb
kta	kqi
ktb	ktu
ktc	xtc
kte	kcv
kth	gwi
kti	yon
ktk	aal
ktl	kcr
ktn	xte
kto	ktw
ktp	zlm
ktt	
ktu	ktv
kty	kca
ktz	bsh
kua	sdm
kug	cmn
kui	kxu
kuk	bfa
kul	gmo
kum	kfy
kun	kvn
kuo	kto
kuq	kum
kur	kru
kus	kgg
kut	kut
kuu	kuy
kuv	kxv
kuy	vkt
kuz	mbt
kwa	kwd
kwb	kwe
kwe	knj
kwk	kwk
kwm	ksq
kwn	kwn
kwo	kmo
kwr	tnk
kws	xaw
kwt	kwo
kwy	kwy
kwz	
kxo	xuu
kya	gvn
kyg	ken
kyk	kyc
kyl	eky
kym	uzn
kyn	koy
kyo	kny
kyp	txu
kyq	nuk
kyr	yuj
kyt	gbb
kyz	kyz
kzh	doc
kzy	kpv
laa	gdm
lab	lbu
lac	lac
lad	lbj
laf	laf
lag	kot
lah	lhu
lai	cnh
lak	lbe
lal	ywt
lam	lme
lan	laj
lao	lao
lar	lrg
lat	lav
lat	lvs
lau	llu
lav	lvk
laz	lzz
lbu	lun
lch	lbt
lcr	acf
lda	lug
ldn	lld
ldo	bdu
ldu	led
leb	agh
lec	lec
leg	lea
lel	lln
len	tnl
lep	lep
les	les
let	lti
lew	lww
lez	lez
lga	ojv
lge	nds
lgh	
lgi	lag
lgp	psr
lgt	log
lgu	lgu
lha	lha
lho	lhm
lic	lic
lii	ise
lil	lil
lim	lif
lin	lin
lis	lis
lit	lit
liv	liv
lje	law
lkk	lbc
lkt	lkt
lla	lby
llm	lef
lma	lom
lmb	lam
lmg	hia
lmh	slp
lml	lmc
lmn	lmn
lmp	ljp
lmu	lmu
lnd	liy
lng	enx
lnj	lnj
lno	lad
lns	lns
lnw	crc
lob	lob
lok	lok
lon	los
lot	njh
lou	loj
lov	lbo
loz	loz
lrd	lbz
lrk	alo
lsa	aed
lsb	bzs
lse	ssp
lsf	fsl
lsq	fcs
lu	khb
lua	nie
luc	lch
lud	lnd
lug	lgg
lui	lui
lul	
lum	str
lun	nst
luo	luo
lur	lrc
lus	lut
luv	lue
lux	ltz
luy	luy
lye	lee
ma	msj
maa	mas
mab	mde
mac	mbc
mad	mhi
mae	mme
mag	mgp
mah	mrj
mai	mai
maj	mpe
mak	myh
mal	plt
mam	mvc
man	mev
mao	mri
map	arn
mar	mrc
mas	mcn
mau	mph
mav	mbw
maw	mlq
max	mbl
may	ayz
maz	maz
mba	mfc
mbb	
mbe	mdt
mbg	mhd
mbi	baw
mbl	mdq
mbm	mdd
mbo	mxk
mbr	mpk
mbt	mdj
mbu	mle
mby	myb
mbz	mtk
mca	mca
mcc	
mcd	mkd
mce	bzj
mcf	crg
mcg	mbn
mch	mcb
mcn	myy
mco	mco
mcr	mfe
mcs	csm
mcv	moc
mda	mxu
mdb	dmw
mde	men
mdg	mua
mdk	mnk
mdl	zml
mdm	
mdn	mhq
mdo	gmm
mdr	mad
mds	xmm
mdu	muh
mdw	mdw
mdz	mda
mea	mej
meb	bew
mee	mym
meh	gdq
mei	mni
mek	skf
mel	mel
mem	jet
men	mez
mer	ulk
mey	mcr
mga	ndt
mgd	mog
mge	mng
mgg	mjg
mgh	mag
mgi	mgu
mgk	mhk
mgl	xmf
mgn	mdh
mgo	lol
mgq	mge
mgu	mug
mhc	xpq
mhi	mar
mhk	nux
mhl	mrg
mhm	mhe
mhu	lnb
mic	mic
mid	mei
mie	ium
mig	mmy
mii	tma
mij	mxj
mik	mjw
mil	adi
min	min
mir	mep
mis	miq
mit	zmq
miy	mkf
miz	lus
mja	mxt
mjc	mjc
mjk	mfv
mka	mxx
mkb	csi
mkd	kde
mke	mek
mkg	mnk
mkh	
mki	mik
mkj	mkz
mkl	mgf
mkn	knf
mko	moz
mkq	nge
mkr	msy
mks	mak
mku	zmr
mkw	
mkz	mcp
mla	mcu
mla	mzk
mlc	mcm
mle	mdy
mlg	mfi
mli	gcc
mlk	mpb
mll	mbe
mlm	mra
mlt	mlt
mlu	mgl
mly	zsm
mma	mid
mmb	mna
mme	mhr
mmi	mcs
mmn	mmn
mmo	mdf
mmp	maw
mms	mqj
mmu	zmi
mmv	mdi
mmw	mgr
mmz	mms
mna	mnb
mnc	mnc
mnd	cmn
mne	nmu
mng	mqy
mni	mnz
mnj	mpj
mnk	emk
mnm	mva
mno	mnr
mnr	mdr
mns	mns
mnt	mwv
mnu	mji
mnv	mvn
mnx	glv
mny	zmc
mnz	moj
moa	mte
moc	moy
moe	myv
mof	mif
mog	mhj
moh	moh
moj	mov
mok	mkj
mol	ron
mom	mso
mon	mnw
moo	mos
mop	mop
mor	mhz
mos	cas
mot	siw
mou	mgd
mov	mzp
mpa	mwf
mpo	mye
mpr	
mpt	mpt
mpu	akc
mpy	mcg
mqc	gcf
mqf	mqf
mra	mec
mrc	rnp
mrd	mrz
mrg	mrt
mrh	mfr
mri	mok
mrj	nju
mrk	mtf
mrl	mur
mrn	mrw
mro	mor
mrq	mrq
mrr	zmt
mrs	zrs
mrt	vma
mru	mhx
mrw	zmu
msc	chb
mse	umu
msg	mrg
msh	mah
msk	jle
msl	mls
msm	msu
msn	mbq
msq	hur
mss	skd
msy	mrd
mta	sdo
mtb	mgw
mtg	moe
mth	mxp
mti	mot
mtk	mjk
mtl	mvb
mto	kmj
mtp	mto
mts	mpq
mtt	wam
mtu	meu
mua	mgh
mud	mnf
mug	mlp
muh	sgw
mui	bmr
mul	mlm
mum	mzm
mun	unr
muo	mtq
mup	sur
mur	muz
mus	emi
mut	css
muu	myu
muy	myw
mwa	mpj
mwb	mbb
mwc	mke
mwe	mwe
mwl	lmw
mwn	nsq
mwo	mlv
mwp	pmw
mxa	mib
mxc	mig
mxe	mxe
mxg	mig
mxj	mio
mxl	mim
mxm	mig
mxo	mie
mxp	mil
mxs	mks
mxt	miy
mxu	mih
mxx	mxp
mxy	mpm
mxz	miz
mya	slz
myg	mdm
myi	mpc
myk	zlm
mym	mal
myn	mhy
myo	mfy
myr	mcf
myy	
mzc	maq
mzh	mau
mzn	mzn
naa	cld
nab	naf
nad	mbj
naf	nfr
nag	nce
nah	nll
nai	gld
naj	aij
nak	nak
nal	nal
nam	nnm
nan	kln
nap	trg
nar	nrb
nas	nas
nat	ncz
nau	nau
nav	nav
nax	nxq
nbb	nmb
nbd	dgl
nbe	ngc
nbh	ghl
nbk	ntu
nbm	nbm
nbo	now
nbr	gym
nca	caq
ncm	bud
ndb	nbl
nde	nnb
ndg	ndz
ndi	nbw
ndj	djj
ndo	ndo
ndr	fij
ndt	ndv
ndu	nmd
ndy	djk
ned	dse
neg	neg
neh	nsn
nel	nee
nen	yrk
nep	npi
nep	nep
nev	ood
new	new
ney	ney
nez	nez
nga	nio
ngb	nga
ngd	nxg
nge	nge
ngg	nam
ngi	wyb
ngj	nju
ngk	nam
ngl	nig
ngm	sba
ngn	nid
ngo	ngo
ngr	nay
ngt	nmf
ngu	llp
ngw	nxn
ngy	nbj
ngz	ngi
nha	
nhc	nhn
nhh	nhe
nhh	nhw
nhm	ncl
nhn	ncj
nhp	
nht	nhg
nhu	
nhx	ngu
nia	nia
nic	ncb
nif	num
nih	jsl
nim	nir
nin	niz
nis	njz
nit	dtd
niu	niu
niv	niv
nju	nys
nkb	ngk
nke	isi
nkk	nck
nkn	nko
nko	cgg
nkr	nkr
nkt	cbn
nku	xnz
nlr	nrk
nlu	nrl
nly	nly
nma	nbi
nmb	nab
nmd	smq
nmi	nhx
nmm	nmm
nmp	
nnc	ncb
nnd	anh
nne	nen
nng	nyj
nnk	nnk
nnm	tvl
nnn	nuv
nnt	nnt
nob	fia
noc	njb
nog	nog
nok	nog
nom	not
non	nhu
noo	snf
nor	nob
npa	nhp
nph	npa
npi	pcm
npn	nag
npu	npy
nrg	sen
nrm	nrm
nro	nhr
nse	nse
nsg	ncg
nsk	nsk
nsn	nsz
nsy	aii
nsz	azz
nte	nsl
nti	niy
ntj	ntj
ntn	ntm
nto	nto
ntu	yrk
nua	nxl
nub	kcn
nue	nus
nug	nuy
nuk	mbr
nun	nut
nup	nup
nus	nuf
nuu	noo
nvs	niv
nwd	new
nya	nyt
nyg	nyp
nyh	nih
nyi	nyi
nyk	tpq
nyl	yly
nym	nym
nyn	nyh
nyr	nna
nyu	nyv
nza	nzk
nze	nzm
nzs	nzs
obg	ogu
obk	afz
obo	ann
oca	oca
occ	oci
ocu	ocu
ogb	ogb
oi	oyb
oir	xal
oix	otz
oji	ojg
ojm	ciw
ojs	ojs
oka	oka
oko	ort
oks	opm
oku	oku
olm	nij
olo	ong
olu	plo
oma	omg
omh	oma
omi	aom
ond	one
one	aun
ong	oon
onn	ono
ono	ons
ood	ood
ora	ema
orb	gax
orc	oac
ord	mvf
ore	ore
orh	hae
ori	ras
ork	oaa
orl	oro
orm	oru
oro	okv
orw	ssn
ory	ury
osa	osa
osm	otq
oss	oss
otm	ote
oto	iow
otr	otr
ots	otm
owc	gaz
owi	owi
oya	ori
paa	pqa
pac	pac
pad	pdo
pae	pbb
pag	pgu
pai	pwn
pak	pkn
pal	pau
pam	pbs
pan	pan
pap	pap
par	lkr
pat	ptp
pau	pad
paw	pwa
pba	pia
pcm	poc
pdp	ppo
pec	pay
pem	aoc
pen	peg
per	pip
pga	plg
pgl	pif
phl	pww
pia	pid
pil	piv
pin	piu
pip	ppl
pir	pib
pis	psa
pit	pjt
pkm	poh
pkn	drl
pkt	pko
pla	gob
plb	pox
plg	rbb
plg	pce
plh	plh
plk	plu
plp	nij
plr	fap
pmc	poo
pme	peb
pmn	pej
pms	pma
pna	pmf
png	pbr
pnn	pag
pno	pao
pnr	pbh
pnu	buh
pnx	kre
pny	pnw
poa	fwa
poc	poa
pod	pbi
pog	poy
poh	pon
pok	rwa
pol	pol
pop	pbe
por	por
pot	pot
pow	pim
ppc	pio
ppi	pit
pra	prn
prc	pab
prd	pci
pre	asa
prh	myp
pri	pre
prk	prx
pro	oci
prs	pes
prt	pir
psh	pst
psj	poe
psl	psd
psm	pqm
pso	pom
psv	pbf
psw	psw
pta	duf
pte	pck
ptp	gfk
ptt	lae
ptw	pwu
pui	pui
puk	prk
pul	puw
pum	pmj
pum	pmi
pun	wdj
puq	
pur	tsz
put	ute
pwn	paw
qaf	aar
qan	qxa
qaw	alc
qay	quy
qbo	quh
qbo	qul
qca	qvc
qch	quc
qco	quh
qcu	quz
qec	qug
qhu	qvh
qia	cng
qia	qxs
qim	qvi
qta	qvn
que	yum
qui	qui
qum	qum
rad	rad
rag	lml
ral	ral
ram	rma
rao	rao
rap	rap
ras	ras
rav	rmn
raw	raw
rbg	rmo
rbu	rmn
rcp	
rej	rej
rem	bfw
ren	rel
res	rgr
ret	tnc
rga	rng
rgc	jya
rgn	rog
ria	ran
rik	rkb
rim	rim
rit	rit
rji	rji
rka	rmy
rlo	rmy
rmb	rmb
rmc	roh
rnd	run
rng	ren
rnn	mnv
rnr	rml
rny	nyn
rom	ron
ron	cla
ror	rro
rot	rtm
rov	rug
rpa	bod
rru	nyo
rsc	roh
rse	
rsh	sgh
rsl	rsl
rsm	roh
rsu	roh
rti	twu
rtk	roo
ruk	dru
rum	klq
run	rou
rus	rus
rut	rut
rwa	rwo
rwe	rmw
ryu	ryu
saa	apb
sab	snv
sae	skb
sah	saj
sak	sku
sal	sln
sam	smo
san	sag
sao	ssy
sap	spu
sar	dju
sav	sdg
saw	hvn
say	pos
sba	slc
sbg	sse
sch	str
scr	bos
scr	hrv
scr	srp
scs	sma
sdh	snd
sdw	sad
sea	tvk
seb	kpz
sec	sey
sed	sed
see	trv
sel	ona
sem	nsm
sen	seh
ser	sei
ses	sot
sey	crs
sgb	mnx
sge	sop
sgl	szg
sgr	sxn
sgs	str
sgu	snq
sha	shn
shb	sbf
shd	sdp
she	xsr
shg	bod
shh	mcd
shi	shb
shk	shp
shl	shk
shm	ksb
shn	sna
sho	shh
shp	waa
shr	cjs
shs	sht
sht	shj
shu	shs
shw	sjw
shy	yuy
sia	snp
sid	sid
sik	ski
sil	dau
sim	smr
sin	snn
sio	xsi
sir	sjr
sis	baa
siu	sis
ski	sjd
skk	sip
skl	skh
skm	suk
skn	guh
sko	skv
skp	sel
skr	tty
sku	sub
skw	swv
sla	scs
slb	sbe
sle	ndi
slg	suv
slo	slv
slp	spl
slr	slr
slv	xsl
sly	sly
smd	sdm
sme	sif
smj	sea
sml	sza
smn	mus
smp	
smt	uma
sna	scl
snc	see
snd	sef
sng	snc
snh	sin
snm	xsu
snn	snk
sno	sme
snt	set
so	teu
sob	sob
sod	gru
sol	evn
som	som
son	sov
soo	str
soq	sqt
sor	srb
sou	hsb
spa	spa
spc	spa
spi	bod
spo	spo
sps	slh
squ	squ
sra	srn
srb	dsb
src	srs
srd	sro
sre	kpm
sri	sri
srl	dsb
srm	srm
srn	srq
sro	ssd
srr	ser
sru	slu
sry	fos
ssa	sld
ssh	bwo
ssl	kvk
sss	str
sst	str
sta	sce
sti	sti
stl	sat
stn	nso
sto	sto
sub	sbs
sud	tgo
sue	sue
sug	sjg
sui	swi
suk	sui
sul	sua
sum	yan
sun	sun
sup	spp
sur	sgz
sus	sus
sva	sva
svc	csb
svk	slk
svs	svs
svt	swl
swa	swh
swe	swe
swi	szw
swr	shh
swt	ssw
swv	swe
syg	ybe
syu	sll
tab	mky
tac	tna
taf	sps
tag	tgl
tah	tah
tai	thv
taj	tgk
tak	tbc
tal	tlj
tam	taj
tam	tge
tan	tan
tao	tro
tap	gpn
taq	nan
tar	tae
tas	shi
tat	txx
tau	tya
taw	tbo
tay	cks
taz	tly
tba	sst
tbb	tub
tbe	tig
tbl	tnm
tbo	tbl
tbr	tby
tbs	tab
tbt	tti
tbu	dzg
tbu	tuq
tbw	tap
tbx	skj
tce	tar
tda	tcx
tdi	bod
tdr	bod
tec	ttc
tee	tee
teh	teh
tel	tel
tem	kdh
ten	tex
teo	tio
tep	tpt
ter	ttr
tes	teo
tet	tll
tew	tew
tex	kmz
tga	hrc
tgb	tbw
tgh	thv
tgk	tgc
tgl	tsj
tgn	tzn
tgo	tsv
tgp	swt
tgr	tig
tgw	txn
tha	tha
thd	tcz
thk	ths
thn	thf
tho	thp
thp	typ
ths	tsq
tht	kps
thu	tdh
thw	ssf
thy	thd
tia	tms
tib	bod
tic	tca
tid	tvo
tif	tif
tig	tir
tik	tik
til	til
tim	tih
tin	cir
tir	tri
tis	bod
tiv	tiv
tiw	tiw
tja	dih
tke	tkl
tki	bag
tkl	tkm
tkm	tuk
tks	kkw
tla	ksd
tlb	nog
tld	tld
tlf	tlf
tli	tli
tll	tuh
tlo	tlb
tlp	tcf
tls	tly
tma	tma
tmc	tjm
tmg	tcg
tmi	tat
tmk	tmc
tml	tam
tmm	mla
tmn	teq
tmo	bod
tmp	tpm
tmr	tea
tms	
tmu	ttt
tna	tuv
tnb	tnd
tnc	tcb
tnd	tin
tne	tem
tng	ton
tni	lbf
tnj	tfn
tnk	lcm
tnl	taa
tnn	tvu
tno	tdn
tns	nwi
tnt	tnt
tny	kza
toa	tqo
tob	tob
tod	sbu
tof	kim
toj	toj
tok	yer
tol	jic
ton	tqw
toq	mlu
tor	rth
tos	tos
tot	tlc
tou	wib
tow	wib
toy	
toz	toi
tpa	top
tpc	tep
tpi	tpi
tpn	ntp
tpr	tui
tps	stp
tpt	tpj
trb	tfr
trc	trs
trd	sda
trg	tew
tri	trc
trm	suq
trn	ter
trr	tbg
trt	tft
tru	tpy
trw	trw
try	tiy
tsa	tkr
tse	aoz
tsf	cof
tsg	tsg
tsh	par
tsi	tsi
tsj	tew
tsk	taq
tsl	tza
tsm	
tsn	tso
tso	tsu
tsp	tam
tsr	trr
tst	huq
tsw	tsn
tsz	ddo
ttb	tat
ttd	tet
tte	tta
ttn	tet
tts	tks
ttu	bbl
tty	tav
tua	pmt
tub	tbu
tuc	tuo
tug	thv
tui	tsm
tuk	khc
tuk	bhq
tul	tcy
tum	tmq
tun	tun
tup	
tur	tur
tus	tus
tut	ttm
tuv	tyv
tuy	tue
tvl	tvl
tvo	tat
tvt	tvt
twa	twa
twe	tac
twn	twf
tws	tix
twx	kmz
txj	too
tye	woa
tza	tzh
tzb	tzb
tze	tzb
tze	tzh
tzi	tss
tzo	tzo
tzs	tzs
tzt	tzh
tzu	tzj
tzz	tzz
uby	uby
udh	ude
udi	udi
udm	udm
ugs	ugn
uhi	urf
ukr	ukr
uku	kuu
ulc	ulc
uld	udl
uli	uli
uma	ppk
umb	umb
ump	ump
umu	cbd
una	mtg
ung	ung
unm	unm
ura	uur
urd	urd
urh	urh
uri	uri
urk	urb
url	urk
urm	uum
urn	ura
urt	urt
uru	ure
usa	wnu
usl	uks
usr	usa
ute	ute
uyg	uig
uzb	uzs
uzn	uzn
vaf	vaf
vag	vag
vai	vai
vas	vas
vat	dic
ved	ved
ven	ven
vep	vep
vie	vie
vif	vif
vka	vka
vla	vgt
vnm	vnm
vot	vot
wag	waq
wah	wgi
wai	waw
wak	wbl
wal	van
wam	wmb
wan	xwk
wao	auc
wap	wao
war	pav
was	was
wat	wbv
wau	noa
way	oym
wbn	wms
wbt	wbt
wch	mzh
wdo	
wec	cym
wed	wed
wel	cym
wem	
wer	wer
wet	lex
wgg	wgg
wgl	wbk
wgu	wrg
wic	wic
wik	yok
win	wnw
wir	wgu
wiy	wiy
wkw	wkw
wlf	wol
wll	wls
wlm	wmt
wlo	wlo
wlw	wrb
wly	wal
wma	mqs
wme	wme
wmn	wem
wmu	wim
wn	wig
wna	wan
wnb	win
wnt	wnc
wob	wob
wog	wog
woi	woi
wol	woe
wom	
wor	wro
wps	wap
wra	wba
wrb	
wrd	wrr
wrg	wgy
wrk	gae
wrl	wbp
wrm	wsa
wrn	wnd
wrp	wrp
wrs	wrs
wru	wrm
wrw	wwr
wry	wrz
wsk	wsk
wth	
wtm	wax
wuc	wuu
wur	wau
wwa	wwa
wwr	
wwy	war
wya	wya
wyn	way
xam	xam
xar	ane
xas	kao
xav	xav
xbi	xbi
xer	xer
xho	xho
xia	nan
xns	xns
xok	xok
xoo	nmn
xsm	xsm
xun	knw
yag	yad
yah	yag
yak	yaf
yal	kkl
yam	yaa
yan	ynn
yao	yao
yap	yap
yaq	yaq
yar	yrb
yav	yuf
yaw	yva
yay	pcc
yaz	yah
yba	yam
ybi	ybi
ych	esu
ycn	ycn
yct	yua
ydb	ydd
ydd	ydd
ydd	yih
ydl	ydd
yei	jei
yel	yle
yem	ybb
yes	yss
yey	yey
ygd	dur
ygn	yai
ygr	ygr
yi	iii
yid	yii
yil	yll
yim	yee
yin	yij
yir	yyr
yki	yuk
ykm	yky
ykn	yka
yko	yux
ykp	yup
ykt	sah
ylb	mpj
yli	yli
ylm	jel
ylr	ylr
ylt	ydd
ymd	jmd
ymi	tao
yms	jnj
yna	ynk
yng	yia
ynk	kdd
ynm	wca
yns	yns
yny	jao
yok	yok
yor	yor
ypk	esu
yqy	jaq
yrc	yuz
yrm	
yrr	yae
yrt	yui
ysi	ysr
ysl	ess
yta	nog
ytu	ykg
yuc	yuc
yug	yug
yuk	gcd
yul	yul
yun	esu
yur	yur
yus	ess
yuw	kld
ywl	yok
ywr	ywr
yyg	
yyo	
yzv	kpv
zag	zag
zai	zai
zaj	zaa
zam	zpm
zan	zne
zap	zaw
zaq	zpi
zar	dje
zay	zay
zaz	diq
zch	zoh
zen	zen
zfl	zos
zha	jna
zhn	zgb
zim	zik
zno	zul
zpi	zpd
zpr	zro
zqc	zoc
zqo	zoc
zqr	zor
zqs	poi
zso	zul
zsq	zab
zte	zpz
zul	zul
zun	zun
zya	zav
zzo	zpq
aym	ayr
bai	bfs
bbf	bwq
biq	bps
btk	lbk
cos	cst
dda	dwu
djp	dwu
est	ekk
est	vro
gan	gac
gla	aou
gla	giw
gon	esg
gon	wsg
gwa	gby
kiw	kiw
kkv	kvc
kul	dwr
lng	enl
lur	luz
mdm	dmd
nbk	nlz
nis	tgj
oya	ory
pnu	pnu
sum	ulw
tlp	tpx
wan	jbi
wan	xpt
wor	xgu
wrb	wx0
